replication,blocksize,dimension,start_reduce_percentage,reducers,taskio,start_time,start_reduce,end_time,total_time
2,20480000,4600000000,0.75,12,100,1457367584,1457367731,1457367836,252
4,99840000,5700000000,0.35,12,100,1457770876,1457770974,1457771132,256
4,20480000,4600000000,0.35,12,100,1457383254,1457383359,1457383500,246
2,99840000,400000000,0.5,12,100,1456976644,1456976691,1456976705,61
4,168960000,3800000000,0.75,12,100,1457397550,1457397711,1457397781,231
4,168960000,4600000000,0.75,12,100,1457394833,1457394917,1457395187,354
1,19968000,700000000,0.75,12,100,1457167311,1457167362,1457167415,104
2,104960000,4600000000,0.35,12,100,1457731317,1457731382,1457731534,217
2,33280000,400000000,0.5,12,100,1456973467,1456973501,1456973556,89
3,256000000,1500000000,0.35,12,100,1457232892,1457232979,1457233017,125
4,16640000,500000000,0.05,12,100,1456991562,1456991605,1456991671,109
4,99840000,500000000,0.05,12,100,1456998108,1456998134,1456998158,50
1,168960000,3800000000,0.75,12,100,1457365300,1457365377,1457365384,84
4,168960000,1800000000,0.75,12,100,1457249815,1457250270,1457250356,541
1,99840000,380000000000,0.75,12,100,1458054491,1458060189,1458063376,8885
1,128000000,620000000000,0.5,12,100,1458471056,1458477164,1458487031,15975
3,33280000,200000000,0.05,12,100,1456982317,1456982342,1456982352,35
3,104960000,6200000000,0.75,12,100,1457760104,1457760233,1457760321,217
4,99840000,400000000,0.5,12,100,1456996863,1456996967,1456997029,166
2,20480000,3800000000,0.75,12,100,1457370142,1457370266,1457370287,145
2,168960000,3800000000,0.35,12,100,1457380643,1457380733,1457381125,482
3,99840000,600000000,0.9,12,100,1457107295,1457107491,1457107511,216
4,20480000,5700000000,0.75,12,100,1457385297,1457385479,1457385561,264
1,168960000,1800000000,0.75,12,100,1457223236,1457223309,1457223324,88
3,104960000,5700000000,0.35,12,100,1457755786,1457755885,1457756035,249
1,16640000,200000000,0.5,12,100,1456958149,1456958176,1456958186,37
1,104960000,6200000000,0.75,12,100,1457715641,1457715759,1457715880,239
2,168960000,5700000000,0.75,12,100,1457380017,1457380137,1457380254,237
2,168960000,4600000000,0.35,12,100,1457378200,1457378282,1457378431,231
3,20480000,3600000000,0.35,12,100,1457225369,1457225443,1457225608,239
1,20480000,2700000000,0.75,12,100,1457212403,1457212513,1457212557,154
2,104960000,4600000000,0.5,12,100,1457732520,1457732585,1457732734,214
3,33280000,300000000,0.5,12,100,1456982678,1456982761,1456982828,150
1,19968000,600000000,0.75,12,100,1457166450,1457166497,1457166546,96
1,20480000,1800000000,0.35,12,100,1457212904,1457212952,1457213020,116
1,128000000,4600000000,0.35,12,100,1457716832,1457716903,1457717061,229
3,256000000,1500000000,0.75,12,100,1457233357,1457233478,1457233512,155
2,99840000,5700000000,0.75,12,100,1457726376,1457726486,1457726614,238
1,168960000,4600000000,0.35,12,100,1457361471,1457361549,1457361990,519
2,99840000,500000000,0.5,12,100,1456977608,1456977719,1456977908,300
3,104960000,6200000000,0.5,12,100,1457760823,1457760924,1457761057,234
3,128000000,5700000000,0.35,12,100,1457763359,1457763444,1457763589,230
1,99840000,4600000000,0.75,12,100,1457702799,1457702900,1457703020,221
1,19968000,1500000000,0.75,12,100,1457169194,1457169269,1457169340,146
4,20480000,1500000000,0.35,12,100,1457241385,1457241431,1457241512,127
4,256000000,5700000000,0.75,12,100,1457390434,1457390581,1457390665,231
3,33280000,400000000,0.5,12,100,1456983537,1456983608,1456983704,167
1,20480000,3800000000,0.75,12,100,1457352067,1457352210,1457352313,246
3,99840000,700000000,0.9,12,100,1457107856,1457108018,1457108023,167
1,104960000,380000000000,0.5,12,100,1458246326,1458250269,1458255353,9027
1,76800000,1500000000,0.35,12,100,1457172579,1457172632,1457172691,112
4,104960000,3800000000,0.35,12,100,1457780670,1457780732,1457780862,192
4,104960000,5700000000,0.75,12,100,1457779352,1457779464,1457779592,240
4,99840000,4600000000,0.75,12,100,1457769611,1457769715,1457769822,211
1,128000000,4600000000,0.75,12,100,1457717419,1457717518,1457717641,222
2,168960000,4600000000,0.75,12,100,1457378810,1457378896,1457379009,199
4,99840000,4600000000,0.5,12,100,1457770235,1457770299,1457770453,218
4,128000000,3800000000,0.5,12,100,1457789581,1457789651,1457789794,213
4,99840000,3800000000,0.5,12,100,1457774131,1457774192,1457774329,198
2,128000000,3800000000,0.5,12,100,1457743646,1457743715,1457744001,355
4,168960000,3600000000,0.75,12,100,1457247418,1457247557,1457247624,206
2,20480000,3800000000,0.35,12,100,1457369504,1457369576,1457369759,255
4,99840000,3800000000,0.75,12,100,1457773528,1457773627,1457773714,186
4,99840000,800000000,0.9,12,100,1457113898,1457113956,1457113970,72
4,256000000,3800000000,0.35,12,100,1457391068,1457391173,1457391326,258
4,168960000,3800000000,0.35,12,100,1457396928,1457397010,1457397160,232
3,99840000,800000000,0.9,12,100,1457108384,1457108440,1457108453,69
3,256000000,3600000000,0.35,12,100,1457229404,1457229509,1457229523,119
4,66560000,800000000,0.9,12,100,1457111969,1457112074,1457112121,152
3,128000000,5700000000,0.75,12,100,1457764014,1457764134,1457764234,220
3,76800000,700000000,0.75,12,100,1457182935,1457183130,1457183189,254
3,99840000,5700000000,0.5,12,100,1457749498,1457749603,1457749738,240
3,99840000,4600000000,0.5,12,100,1457747517,1457747581,1457747751,234
4,99840000,5700000000,0.5,12,100,1457772287,1457772390,1457772521,234
4,256000000,1500000000,0.75,12,100,1457246330,1457246423,1457246457,127
3,99840000,6200000000,0.5,12,100,1457753186,1457753311,1457753406,220
1,168960000,3600000000,0.35,12,100,1457219641,1457219720,1457220170,529
3,128000000,3800000000,0.75,12,100,1457765884,1457766014,1457766099,215
1,128000000,6200000000,0.35,12,100,1457722079,1457722151,1457722332,253
1,20480000,4600000000,0.35,12,100,1457348667,1457348754,1457349029,362
3,33280000,200000000,0.5,12,100,1456981945,1456981977,1456981995,50
3,104960000,6200000000,0.35,12,100,1457759410,1457759507,1457759656,246
2,168960000,6200000000,0.35,12,100,1457381953,1457382037,1457382175,222
4,99840000,500000000,0.5,12,100,1456997719,1456997770,1456997784,65
1,128000000,570000000000,0.75,12,100,1458370229,1458378611,1458382745,12516
1,256000000,3600000000,0.35,12,100,1457214775,1457214872,1457214968,193
1,168960000,6200000000,0.75,12,100,1457366341,1457366462,1457366565,224
4,20480000,3800000000,0.35,12,100,1457385925,1457385998,1457386176,251
2,104960000,4600000000,0.75,12,100,1457731916,1457732019,1457732145,229
2,16640000,200000000,0.05,12,100,1456968831,1456968853,1456968861,30
3,33280000,300000000,0.05,12,100,1456983155,1456983183,1456983211,56
4,104960000,6200000000,0.5,12,100,1457783767,1457783869,1457784003,236
4,128000000,3800000000,0.75,12,100,1457788946,1457789017,1457789175,229
2,99840000,210000000,0.05,12,100,1456955245,1456955269,1456955289,44
4,104960000,5700000000,0.5,12,100,1457780035,1457780157,1457780272,237
1,99840000,570000000000,0.35,12,100,1457991031,1457995070,1458007094,16063
1,20480000,4600000000,0.75,12,100,1457349385,1457349531,1457349649,264
4,128000000,5700000000,0.35,12,100,1457786308,1457786395,1457786545,237
4,20480000,5700000000,0.35,12,100,1457384580,1457384680,1457384869,289
2,104960000,5700000000,0.5,12,100,1457734390,1457734495,1457734624,234
4,168960000,4600000000,0.35,12,100,1457394203,1457394287,1457394429,226
1,16640000,400000000,0.05,12,100,1456960090,1456960117,1456960215,125
1,168960000,1800000000,0.35,12,100,1457222402,1457222781,1457222893,491
1,33280000,500000000,0.5,12,100,1456964065,1456964104,1456964213,148
2,99840000,3800000000,0.5,12,100,1457728764,1457728826,1457728966,202
4,128000000,6200000000,0.75,12,100,1457790880,1457791012,1457791088,208
1,20480000,6200000000,0.75,12,100,1457353508,1457353716,1457353869,361
1,20480000,6200000000,0.35,12,100,1457352710,1457352812,1457353086,376
1,104960000,620000000000,0.35,12,100,1458258087,1458262606,1458274887,16800
1,128000000,6200000000,0.75,12,100,1457722721,1457722848,1457722943,222
3,168960000,3600000000,0.35,12,100,1457233882,1457233966,1457234090,208
4,19968000,1500000000,0.75,12,100,1457192261,1457192314,1457192387,126
1,256000000,1500000000,0.75,12,100,1457218775,1457219084,1457219286,511
3,16640000,800000000,0.9,12,100,1457104262,1457104359,1457104380,118
4,104960000,6200000000,0.75,12,100,1457783109,1457783220,1457783344,235
1,33280000,400000000,0.5,12,100,1456963110,1456963175,1456963257,147
3,20480000,1800000000,0.35,12,100,1457227465,1457227502,1457227590,125
4,76800000,600000000,0.35,12,100,1457192725,1457192775,1457192789,64
3,104960000,5700000000,0.75,12,100,1457756446,1457756557,1457756679,233
3,16640000,700000000,0.9,12,100,1457103819,1457103924,1457103928,109
2,128000000,3800000000,0.75,12,100,1457743064,1457743192,1457743276,212
4,20480000,2700000000,0.35,12,100,1457239401,1457239456,1457239537,136
1,99840000,6200000000,0.5,12,100,1457709089,1457709190,1457709320,231
1,148480000,1500000000,0.35,12,100,1457176893,1457176961,1457176983,90
4,99840000,6200000000,0.75,12,100,1457775430,1457775540,1457775666,236
2,99840000,200000000,0.05,12,100,1456975516,1456975559,1456975571,55
1,99840000,400000000,0.05,12,100,1456967025,1456967050,1456967075,50
1,256000000,3600000000,0.75,12,100,1457215335,1457215516,1457216060,725
2,99840000,6200000000,0.75,12,100,1457730069,1457730196,1457730288,219
1,20480000,2700000000,0.35,12,100,1457211822,1457211888,1457212061,239
3,128000000,6200000000,0.35,12,100,1457767069,1457767140,1457767305,236
1,76800000,700000000,0.35,12,100,1457170744,1457170820,1457170906,162
3,33280000,400000000,0.05,12,100,1456984033,1456984070,1456984145,112
1,168960000,4600000000,0.75,12,100,1457362347,1457362427,1457362872,525
4,128000000,4600000000,0.35,12,100,1457784414,1457784484,1457784637,223
4,20480000,3600000000,0.75,12,100,1457238916,1457239040,1457239058,142
1,168960000,2700000000,0.75,12,100,1457221841,1457222014,1457222036,195
2,104960000,6200000000,0.35,12,100,1457736734,1457736800,1457736978,244
1,128000000,5700000000,0.35,12,100,1457718578,1457718648,1457718840,262
4,128000000,3800000000,0.35,12,100,1457788352,1457788428,1457788545,193
1,256000000,3800000000,0.35,12,100,1457357969,1457358063,1457358601,632
4,256000000,3600000000,0.35,12,100,1457242374,1457242475,1457242629,255
2,99840000,5700000000,0.35,12,100,1457725747,1457725814,1457725991,244
1,148480000,700000000,0.75,12,100,1457175344,1457175685,1457175738,394
3,99840000,3800000000,0.35,12,100,1457750117,1457750178,1457750319,202
2,128000000,4600000000,0.75,12,100,1457739291,1457739398,1457739530,239
3,168960000,2700000000,0.35,12,100,1457234965,1457235049,1457235190,225
2,99840000,6200000000,0.35,12,100,1457729423,1457729489,1457729680,257
1,33280000,200000000,0.05,12,100,1456961908,1456961934,1456961944,36
1,99840000,5700000000,0.35,12,100,1457704118,1457704182,1457704389,271
4,33280000,300000000,0.5,12,100,1456992716,1456992748,1456992761,45
4,16640000,400000000,0.5,12,100,1456990310,1456990337,1456990348,38
1,104960000,460000000000,0.35,12,100,1458131900,1458135265,1458144109,12209
2,20480000,4600000000,0.35,12,100,1457366958,1457367044,1457367206,248
3,99840000,6200000000,0.75,12,100,1457752555,1457752663,1457752788,233
1,99840000,570000000000,0.75,12,100,1458009635,1458018182,1458022554,12919
3,168960000,1500000000,0.35,12,100,1457236894,1457236955,1457236979,85
3,16640000,500000000,0.5,12,100,1456981079,1456981119,1456981184,105
1,20480000,3800000000,0.35,12,100,1457351426,1457351508,1457351694,268
1,99840000,5700000000,0.5,12,100,1457705490,1457705615,1457705711,221
4,66560000,700000000,0.9,12,100,1457111508,1457111595,1457111623,115
1,76800000,800000000,0.75,12,100,1457172165,1457172216,1457172239,74
1,256000000,1800000000,0.35,12,100,1457217295,1457217389,1457217396,101
3,128000000,5700000000,0.5,12,100,1457764656,1457764742,1457764879,223
1,99840000,620000000000,0.75,12,100,1458096222,1458105513,1458111072,14850
1,20480000,1500000000,0.75,12,100,1457214276,1457214350,1457214419,143
1,104960000,3800000000,0.35,12,100,1457713250,1457713320,1457713451,201
4,16640000,500000000,0.9,12,100,1457110569,1457110671,1457110685,116
4,128000000,6200000000,0.35,12,100,1457790219,1457790290,1457790457,238
1,104960000,460000000000,0.5,12,100,1458158867,1458163650,1458170105,11238
3,16640000,400000000,0.5,12,100,1456980264,1456980296,1456980376,112
1,148480000,700000000,0.35,12,100,1457174926,1457174988,1457175001,75
1,99840000,570000000000,0.5,12,100,1458025135,1458030872,1458040280,15145
4,76800000,800000000,0.75,12,100,1457194999,1457195082,1457195120,121
3,66560000,700000000,0.9,12,100,1457105696,1457105777,1457105790,94
1,33280000,400000000,0.05,12,100,1456963584,1456963610,1456963732,148
3,20480000,1500000000,0.75,12,100,1457228892,1457228946,1457229019,127
4,99840000,3800000000,0.35,12,100,1457772912,1457772973,1457773112,200
4,16640000,500000000,0.5,12,100,1456991103,1456991135,1456991223,120
4,148480000,1500000000,0.35,12,100,1457199235,1457199307,1457199330,95
3,128000000,4600000000,0.75,12,100,1457762080,1457762180,1457762319,239
1,128000000,570000000000,0.5,12,100,1458385158,1458390755,1458399786,14628
3,20480000,2700000000,0.35,12,100,1457226496,1457226550,1457226624,128
3,128000000,6200000000,0.5,12,100,1457768334,1457768407,1457768570,236
1,256000000,5700000000,0.35,12,100,1457356019,1457356117,1457356553,534
2,256000000,6200000000,0.75,12,100,1457377387,1457377497,1457377824,437
2,20480000,5700000000,0.75,12,100,1457368888,1457369067,1457369135,247
2,99840000,500000000,0.05,12,100,1456978232,1456978259,1456978282,50
1,20480000,1800000000,0.75,12,100,1457213360,1457213426,1457213481,121
3,128000000,6200000000,0.75,12,100,1457767706,1457767825,1457767929,223
3,99840000,3800000000,0.75,12,100,1457750707,1457750809,1457750898,191
3,16640000,500000000,0.9,12,100,1457104705,1457104816,1457104819,114
1,148480000,600000000,0.75,12,100,1457174229,1457174565,1457174597,368
4,76800000,600000000,0.75,12,100,1457193131,1457193290,1457193320,189
1,104960000,380000000000,0.75,12,100,1458235673,1458241564,1458244559,8886
4,99840000,600000000,0.9,12,100,1457113086,1457113139,1457113153,67
2,33280000,200000000,0.5,12,100,1456971809,1456971840,1456971877,68
2,128000000,4600000000,0.35,12,100,1457738677,1457738747,1457738905,228
3,20480000,1800000000,0.75,12,100,1457227933,1457227986,1457228062,129
4,33280000,300000000,0.05,12,100,1456993091,1456993112,1456993130,39
2,20480000,6200000000,0.75,12,100,1457371487,1457371679,1457371750,263
1,168960000,1500000000,0.75,12,100,1457224511,1457224928,1457224971,460
4,16640000,300000000,0.5,12,100,1456989524,1456989561,1456989629,105
4,256000000,3800000000,0.75,12,100,1457391724,1457391942,1457392390,666
4,99840000,400000000,0.05,12,100,1456997349,1456997374,1456997395,46
3,104960000,3800000000,0.5,12,100,1457758823,1457758886,1457759012,189
3,128000000,4600000000,0.5,12,100,1457762713,1457762784,1457762936,223
4,256000000,3600000000,0.75,12,100,1457242979,1457243199,1457243233,254
1,99840000,6200000000,0.35,12,100,1457707835,1457707902,1457708091,256
3,66560000,800000000,0.9,12,100,1457106128,1457106279,1457106367,239
2,33280000,500000000,0.5,12,100,1456974305,1456974333,1456974356,51
4,76800000,700000000,0.75,12,100,1457194061,1457194207,1457194231,170
4,20480000,6200000000,0.75,12,100,1457388009,1457388190,1457388273,264
4,128000000,5700000000,0.75,12,100,1457787030,1457787151,1457787257,227
1,168960000,5700000000,0.35,12,100,1457363257,1457363341,1457363486,229
4,104960000,4600000000,0.5,12,100,1457777982,1457778046,1457778191,209
4,168960000,6200000000,0.35,12,100,1457398205,1457398305,1457398432,227
2,104960000,6200000000,0.5,12,100,1457738041,1457738143,1457738278,237
4,148480000,600000000,0.35,12,100,1457196276,1457196336,1457196350,74
3,168960000,3600000000,0.75,12,100,1457234437,1457234520,1457234574,137
4,99840000,300000000,0.05,12,100,1456996409,1456996530,1456996540,131
4,19968000,600000000,0.75,12,100,1457189469,1457189521,1457189596,127
3,19968000,800000000,0.35,12,100,1457179726,1457179759,1457179863,137
3,19968000,600000000,0.35,12,100,1457177866,1457177901,1457177994,128
4,104960000,3800000000,0.5,12,100,1457781809,1457781872,1457782012,203
3,256000000,2700000000,0.35,12,100,1457230494,1457230585,1457230605,111
2,99840000,460000000000,0.35,12,100,1458561688,1458562328,1458564108,2420
4,148480000,700000000,0.35,12,100,1457197083,1457197142,1457197156,73
4,33280000,500000000,0.5,12,100,1456994389,1456994421,1456994442,53
1,99840000,460000000000,0.5,12,100,1457976246,1457980881,1457988578,12332
1,104960000,620000000000,0.5,12,100,1458294715,1458301156,1458310583,15868
4,99840000,5700000000,0.75,12,100,1457771563,1457771673,1457771797,234
3,148480000,700000000,0.75,12,100,1457186866,1457186923,1457186937,71
1,256000000,1800000000,0.75,12,100,1457217746,1457217896,1457217971,225
1,168960000,5700000000,0.75,12,100,1457363842,1457363964,1457364061,219
2,16640000,300000000,0.5,12,100,1456969181,1456969218,1456969271,90
2,128000000,6200000000,0.75,12,100,1457745031,1457745151,1457745254,223
1,128000000,5700000000,0.5,12,100,1457719791,1457719863,1457720048,257
1,20480000,3600000000,0.35,12,100,1457210696,1457210770,1457210953,257
4,16640000,300000000,0.05,12,100,1456989948,1456989972,1456989989,41
3,104960000,4600000000,0.35,12,100,1457753809,1457753873,1457754026,217
4,256000000,1800000000,0.35,12,100,1457244706,1457244795,1457244809,103
1,16640000,400000000,0.5,12,100,1456959709,1456959745,1456959761,52
2,104960000,5700000000,0.75,12,100,1457733773,1457733884,1457734007,234
3,99840000,5700000000,0.35,12,100,1457748151,1457748267,1457748391,240
1,128000000,3800000000,0.75,12,100,1457720971,1457721043,1457721140,169
4,99840000,500000000,0.9,12,100,1457114296,1457114345,1457114359,63
2,16640000,500000000,0.5,12,100,1456970932,1456970963,1456971049,117
1,20480000,3600000000,0.75,12,100,1457211293,1457211406,1457211471,178
1,99840000,500000000,0.05,12,100,1456967794,1456967877,1456968081,287
1,168960000,6200000000,0.35,12,100,1457365741,1457365839,1457365976,235
2,128000000,6200000000,0.5,12,100,1457745665,1457745738,1457745899,234
1,99840000,3800000000,0.75,12,100,1457706671,1457706771,1457706872,201
2,168960000,6200000000,0.75,12,100,1457382599,1457382711,1457382835,236
1,16640000,500000000,0.5,12,100,1456960548,1456960593,1456960673,125
2,256000000,5700000000,0.75,12,100,1457374436,1457374614,1457374653,217
4,66560000,600000000,0.9,12,100,1457111015,1457111170,1457111178,163
4,168960000,3600000000,0.35,12,100,1457246808,1457246896,1457247019,211
3,99840000,4600000000,0.35,12,100,1457746294,1457746356,1457746519,225
1,128000000,380000000000,0.35,12,100,1458401577,1458404217,1458411696,10119
1,99840000,400000000,0.5,12,100,1456966481,1456966562,1456966704,223
1,128000000,620000000000,0.35,12,100,1458435661,1458439955,1458452160,16499
1,20480000,1500000000,0.35,12,100,1457213818,1457213861,1457213922,104
2,99840000,4600000000,0.35,12,100,1457723950,1457724020,1457724169,219
4,99840000,6200000000,0.35,12,100,1457774764,1457774831,1457775007,243
4,104960000,4600000000,0.75,12,100,1457777356,1457777462,1457777570,214
4,99840000,700000000,0.9,12,100,1457113485,1457113542,1457113563,78
2,16640000,200000000,0.5,12,100,1456968407,1456968461,1456968512,105
1,104960000,5700000000,0.75,12,100,1457712037,1457712153,1457712274,237
1,99840000,200000000,0.05,12,100,1456965305,1456965385,1456965395,90
1,19968000,700000000,0.35,12,100,1457166877,1457166914,1457166981,104
4,66560000,500000000,0.9,12,100,1457112457,1457112733,1457112744,287
3,66560000,600000000,0.9,12,100,1457105145,1457105313,1457105364,219
4,16640000,700000000,0.9,12,100,1457109662,1457109773,1457109775,113
2,99840000,5700000000,0.5,12,100,1457726989,1457727094,1457727224,235
2,99840000,4600000000,0.75,12,100,1457724553,1457724655,1457724760,207
3,104960000,4600000000,0.5,12,100,1457755032,1457755097,1457755244,212
3,20480000,2700000000,0.75,12,100,1457226997,1457227086,1457227127,130
3,76800000,1500000000,0.75,12,100,1457185074,1457185210,1457185247,173
3,76800000,800000000,0.35,12,100,1457183524,1457183570,1457183702,178
1,256000000,2700000000,0.75,12,100,1457216841,1457216936,1457216956,115
3,19968000,800000000,0.75,12,100,1457180196,1457180244,1457180329,133
1,104960000,3800000000,0.5,12,100,1457714401,1457714475,1457714598,197
2,168960000,5700000000,0.35,12,100,1457379388,1457379472,1457379609,221
1,148480000,800000000,0.35,12,100,1457176070,1457176132,1457176145,75
3,20480000,1500000000,0.35,12,100,1457228425,1457228458,1457228554,129
2,256000000,3800000000,0.75,12,100,1457376107,1457376286,1457376311,204
2,128000000,6200000000,0.35,12,100,1457744402,1457744474,1457744640,238
1,104960000,380000000000,0.35,12,100,1458223553,1458226329,1458233985,10432
1,99840000,6200000000,0.75,12,100,1457708487,1457708604,1457708719,232
4,99840000,200000000,0.5,12,100,1456995258,1456995327,1456995338,80
1,104960000,4600000000,0.35,12,100,1457709687,1457709752,1457709917,230
3,256000000,3600000000,0.75,12,100,1457229899,1457230115,1457230154,255
3,19968000,1500000000,0.75,12,100,1457181170,1457181234,1457181288,118
1,256000000,4600000000,0.35,12,100,1457354222,1457354315,1457354746,524
3,99840000,500000000,0.05,12,100,1456988197,1456988242,1456988434,237
4,104960000,6200000000,0.35,12,100,1457782425,1457782524,1457782681,256
2,256000000,4600000000,0.35,12,100,1457372129,1457372241,1457372334,205
2,33280000,300000000,0.05,12,100,1456973038,1456973066,1456973144,106
1,99840000,380000000000,0.35,12,100,1458042116,1458044818,1458052890,10774
1,104960000,6200000000,0.5,12,100,1457716238,1457716340,1457716474,236
4,76800000,1500000000,0.75,12,100,1457195873,1457195922,1457195933,60
4,256000000,4600000000,0.75,12,100,1457389192,1457389301,1457389405,213
1,104960000,620000000000,0.75,12,100,1458277585,1458287188,1458292029,14444
3,148480000,1500000000,0.75,12,100,1457188612,1457188670,1457188686,74
4,19968000,700000000,0.75,12,100,1457190388,1457190432,1457190522,134
3,256000000,1800000000,0.35,12,100,1457231997,1457232090,1457232104,107
4,99840000,4600000000,0.35,12,100,1457768984,1457769048,1457769203,219
3,99840000,6200000000,0.35,12,100,1457751901,1457751999,1457752150,249
4,104960000,3800000000,0.75,12,100,1457781257,1457781337,1457781445,188
4,33280000,200000000,0.05,12,100,1456992356,1456992382,1456992390,34
1,99840000,5700000000,0.75,12,100,1457704881,1457705002,1457705115,234
1,33280000,500000000,0.05,12,100,1456964547,1456964579,1456964612,65
3,66560000,500000000,0.9,12,100,1457106694,1457106936,1457106966,272
2,20480000,6200000000,0.35,12,100,1457370673,1457370777,1457371041,368
3,16640000,600000000,0.9,12,100,1457103348,1457103472,1457103473,125
4,76800000,700000000,0.35,12,100,1457193668,1457193717,1457193731,63
1,104960000,3800000000,0.75,12,100,1457713836,1457713927,1457714043,207
2,99840000,3800000000,0.75,12,100,1457728189,1457728294,1457728381,192
3,99840000,300000000,0.05,12,100,1456986674,1456986717,1456986724,50
1,148480000,800000000,0.75,12,100,1457176476,1457176541,1457176556,80
4,168960000,2700000000,0.35,12,100,1457248012,1457248093,1457248223,211
1,76800000,600000000,0.75,12,100,1457170335,1457170385,1457170399,64
4,128000000,4600000000,0.5,12,100,1457785664,1457785735,1457785886,222
3,76800000,800000000,0.75,12,100,1457184043,1457184136,1457184180,137
1,99840000,500000000,0.5,12,100,1456967399,1456967449,1456967463,64
3,99840000,200000000,0.5,12,100,1456985435,1456985481,1456985515,80
3,19968000,700000000,0.35,12,100,1457178779,1457178811,1457178906,127
1,76800000,1500000000,0.75,12,100,1457173046,1457173182,1457173236,190
1,104960000,5700000000,0.35,12,100,1457711426,1457711492,1457711678,252
1,104960000,4600000000,0.5,12,100,1457710838,1457710902,1457711067,229
3,99840000,500000000,0.5,12,100,1456987815,1456987858,1456987873,58
2,33280000,200000000,0.05,12,100,1456972201,1456972278,1456972351,150
2,104960000,3800000000,0.75,12,100,1457735581,1457735660,1457735784,203
4,20480000,1800000000,0.75,12,100,1457240904,1457240966,1457241023,119
2,33280000,300000000,0.5,12,100,1456972672,1456972705,1456972719,47
3,128000000,3800000000,0.35,12,100,1457765296,1457765366,1457765508,212
3,19968000,600000000,0.75,12,100,1457178321,1457178372,1457178449,128
4,20480000,1500000000,0.75,12,100,1457241850,1457241903,1457241982,132
2,16640000,300000000,0.05,12,100,1456969597,1456969620,1456969714,117
4,256000000,2700000000,0.75,12,100,1457244227,1457244337,1457244345,118
4,168960000,1500000000,0.35,12,100,1457250697,1457250770,1457250785,88
3,256000000,2700000000,0.75,12,100,1457230978,1457231195,1457231658,680
2,256000000,3800000000,0.35,12,100,1457375020,1457375132,1457375731,711
2,99840000,300000000,0.05,12,100,1456976266,1456976309,1456976324,58
3,33280000,500000000,0.5,12,100,1456984472,1456984515,1456984621,149
4,16640000,400000000,0.05,12,100,1456990671,1456990699,1456990779,108
4,20480000,3800000000,0.75,12,100,1457386570,1457386694,1457386711,141
3,148480000,1500000000,0.35,12,100,1457188175,1457188234,1457188251,76
2,99840000,200000000,0.5,12,100,1456975148,1456975191,1456975198,50
1,19968000,800000000,0.75,12,100,1457168240,1457168303,1457168383,143
2,104960000,3800000000,0.5,12,100,1457736124,1457736187,1457736317,193
4,256000000,6200000000,0.75,12,100,1457393595,1457393759,1457393801,206
4,104960000,5700000000,0.35,12,100,1457778685,1457778803,1457778922,237
4,16640000,600000000,0.9,12,100,1457109206,1457109305,1457109330,124
2,168960000,3800000000,0.75,12,100,1457381469,1457381551,1457381576,107
3,33280000,500000000,0.05,12,100,1456984955,1456984978,1456985111,156
3,16640000,300000000,0.5,12,100,1456979389,1456979420,1456979501,112
3,168960000,1800000000,0.35,12,100,1457235963,1457236026,1457236033,70
1,128000000,5700000000,0.75,12,100,1457719195,1457719315,1457719432,237
3,16640000,300000000,0.05,12,100,1456979829,1456979860,1456979934,105
1,33280000,200000000,0.5,12,100,1456961416,1456961564,1456961594,178
1,99840000,620000000000,0.5,12,100,1458113834,1458120089,1458129829,15995
2,16640000,500000000,0.05,12,100,1456971373,1456971402,1456971494,121
3,168960000,1500000000,0.75,12,100,1457237341,1457237794,1457237880,539
1,99840000,4600000000,0.5,12,100,1457703382,1457703448,1457703606,224
3,16640000,200000000,0.5,12,100,1456978598,1456978622,1456978630,32
4,33280000,400000000,0.05,12,100,1456993878,1456993906,1456994062,184
4,256000000,6200000000,0.35,12,100,1457392892,1457393000,1457393097,205
1,99840000,3800000000,0.35,12,100,1457706081,1457706142,1457706305,224
4,76800000,800000000,0.35,12,100,1457194564,1457194617,1457194668,104
1,128000000,620000000000,0.75,12,100,1458454852,1458463889,1458468454,13602
4,148480000,800000000,0.75,12,100,1457198796,1457198862,1457198875,79
1,104960000,5700000000,0.5,12,100,1457712642,1457712766,1457712862,220
4,256000000,1800000000,0.75,12,100,1457245168,1457245450,1457245529,361
3,19968000,700000000,0.75,12,100,1457179249,1457179294,1457179380,131
3,256000000,1800000000,0.75,12,100,1457232443,1457232533,1457232554,111
1,16640000,500000000,0.05,12,100,1456961000,1456961028,1456961096,96
1,128000000,460000000000,0.75,12,100,1458327012,1458333788,1458337211,10199
1,33280000,300000000,0.05,12,100,1456962742,1456962766,1456962782,40
4,33280000,200000000,0.5,12,100,1456991986,1456992017,1456992030,44
3,16640000,500000000,0.05,12,100,1456981513,1456981542,1456981630,117
3,148480000,700000000,0.35,12,100,1457186424,1457186484,1457186525,101
1,99840000,620000000000,0.35,12,100,1458077808,1458082196,1458093579,15771
4,33280000,400000000,0.5,12,100,1456993452,1456993541,1456993556,104
3,76800000,600000000,0.35,12,100,1457181625,1457181664,1457181678,53
1,104960000,570000000000,0.75,12,100,1458191286,1458200106,1458204270,12984
1,128000000,3800000000,0.5,12,100,1457721500,1457721571,1457721719,219
3,16640000,200000000,0.05,12,100,1456978951,1456978975,1456979071,120
1,99840000,300000000,0.05,12,100,1456966095,1456966138,1456966151,56
3,99840000,4600000000,0.75,12,100,1457746906,1457747007,1457747118,212
2,128000000,5700000000,0.35,12,100,1457740545,1457740617,1457740788,243
3,148480000,600000000,0.35,12,100,1457185575,1457185632,1457185644,69
3,128000000,4600000000,0.35,12,100,1457761445,1457761515,1457761665,220
1,19968000,600000000,0.35,12,100,1457166006,1457166041,1457166122,116
4,148480000,700000000,0.75,12,100,1457197486,1457197758,1457197770,284
2,256000000,6200000000,0.35,12,100,1457376764,1457376871,1457377015,251
2,128000000,3800000000,0.35,12,100,1457742469,1457742538,1457742700,231
3,104960000,4600000000,0.75,12,100,1457754421,1457754527,1457754636,215
4,148480000,1500000000,0.75,12,100,1457199670,1457199748,1457199768,98
2,16640000,400000000,0.5,12,100,1456970035,1456970067,1456970161,126
4,16640000,800000000,0.9,12,100,1457110111,1457110208,1457110229,118
2,16640000,400000000,0.05,12,100,1456970484,1456970516,1456970596,112
1,256000000,6200000000,0.35,12,100,1457359894,1457359990,1457360088,194
3,148480000,800000000,0.35,12,100,1457187271,1457187332,1457187427,156
2,256000000,5700000000,0.35,12,100,1457373790,1457373892,1457374027,237
4,99840000,6200000000,0.5,12,100,1457776084,1457776187,1457776322,238
4,99840000,300000000,0.5,12,100,1456996041,1456996085,1456996091,50
1,104960000,570000000000,0.35,12,100,1458172729,1458176875,1458188913,16184
4,20480000,1800000000,0.35,12,100,1457240420,1457240471,1457240543,123
1,20480000,5700000000,0.75,12,100,1457350728,1457350921,1457351070,342
1,16640000,200000000,0.05,12,100,1456958501,1456958523,1456958533,32
3,168960000,2700000000,0.75,12,100,1457235529,1457235608,1457235625,96
3,168960000,1800000000,0.75,12,100,1457236372,1457236488,1457236555,183
4,148480000,600000000,0.75,12,100,1457196678,1457196739,1457196753,75
3,104960000,5700000000,0.5,12,100,1457757093,1457757194,1457757328,235
2,99840000,4600000000,0.5,12,100,1457725137,1457725209,1457725353,216
4,168960000,2700000000,0.75,12,100,1457248580,1457248761,1457249022,442
2,128000000,5700000000,0.5,12,100,1457741826,1457741899,1457742093,267
1,128000000,460000000000,0.5,12,100,1458339270,1458343811,1458351166,11896
3,76800000,700000000,0.35,12,100,1457182525,1457182577,1457182593,68
4,99840000,200000000,0.05,12,100,1456995663,1456995706,1456995720,57
3,99840000,3800000000,0.5,12,100,1457751293,1457751356,1457751497,204
1,128000000,380000000000,0.5,12,100,1458423884,1458427629,1458433039,9155
1,16640000,300000000,0.05,12,100,1456959303,1456959332,1456959387,84
1,99840000,460000000000,0.35,12,100,1457948694,1457951960,1457960944,12250
3,99840000,400000000,0.05,12,100,1456987433,1456987458,1456987480,47
4,168960000,5700000000,0.35,12,100,1457395601,1457395685,1457395846,245
2,128000000,4600000000,0.5,12,100,1457739908,1457739979,1457740156,248
4,256000000,2700000000,0.35,12,100,1457243615,1457243762,1457243841,226
3,128000000,3800000000,0.5,12,100,1457766450,1457766525,1457766650,200
2,99840000,300000000,0.5,12,100,1456975889,1456975933,1456975947,58
3,76800000,600000000,0.75,12,100,1457182010,1457182114,1457182192,182
1,76800000,700000000,0.75,12,100,1457171254,1457171400,1457171427,173
4,168960000,1500000000,0.75,12,100,1457251143,1457251647,1457251674,531
1,104960000,460000000000,0.75,12,100,1458146155,1458153289,1458156723,10568
1,128000000,3800000000,0.35,12,100,1457720417,1457720484,1457720630,213
4,76800000,1500000000,0.35,12,100,1457195478,1457195525,1457195533,55
3,99840000,400000000,0.5,12,100,1456987047,1456987095,1456987109,62
3,20480000,3600000000,0.75,12,100,1457225988,1457226108,1457226128,140
4,19968000,600000000,0.35,12,100,1457189017,1457189050,1457189143,126
2,20480000,5700000000,0.35,12,100,1457368220,1457368321,1457368509,289
4,168960000,1800000000,0.35,12,100,1457249369,1457249443,1457249451,82
2,99840000,400000000,0.05,12,100,1456977034,1456977093,1456977274,240
1,256000000,6200000000,0.75,12,100,1457360442,1457360551,1457361118,676
3,99840000,300000000,0.5,12,100,1456986214,1456986337,1456986355,141
1,33280000,300000000,0.5,12,100,1456962268,1456962353,1456962420,152
3,104960000,3800000000,0.75,12,100,1457758248,1457758336,1457758428,180
4,20480000,6200000000,0.35,12,100,1457387201,1457387302,1457387501,300
1,99840000,460000000000,0.75,12,100,1457963120,1457970023,1457974155,11035
1,148480000,1500000000,0.75,12,100,1457177337,1457177497,1457177520,183
2,256000000,4600000000,0.75,12,100,1457372704,1457372865,1457373375,671
1,256000000,4600000000,0.75,12,100,1457355107,1457355207,1457355667,560
1,20480000,5700000000,0.35,12,100,1457350008,1457350107,1457350370,362
1,256000000,3800000000,0.75,12,100,1457358956,1457359101,1457359498,542
1,128000000,460000000000,0.35,12,100,1458312604,1458315800,1458324893,12289
2,99840000,3800000000,0.35,12,100,1457727590,1457727651,1457727795,205
4,168960000,6200000000,0.75,12,100,1457398854,1457398966,1457399085,231
3,76800000,1500000000,0.35,12,100,1457184539,1457184590,1457184715,176
4,19968000,800000000,0.35,12,100,1457190856,1457190890,1457190988,132
1,104960000,4600000000,0.75,12,100,1457710276,1457710389,1457710472,196
3,99840000,200000000,0.05,12,100,1456985832,1456985875,1456985887,55
3,99840000,5700000000,0.75,12,100,1457748845,1457748954,1457749088,243
4,16640000,200000000,0.05,12,100,1456989111,1456989142,1456989194,83
1,99840000,3800000000,0.5,12,100,1457707242,1457707303,1457707469,227
4,256000000,5700000000,0.35,12,100,1457389894,1457390003,1457390019,125
2,104960000,5700000000,0.35,12,100,1457733122,1457733219,1457733379,257
4,104960000,4600000000,0.35,12,100,1457776736,1457776810,1457776941,205
1,256000000,2700000000,0.35,12,100,1457216399,1457216491,1457216503,104
1,128000000,4600000000,0.5,12,100,1457718002,1457718073,1457718222,220
1,128000000,570000000000,0.35,12,100,1458353718,1458357669,1458367718,14000
1,19968000,1500000000,0.35,12,100,1457168723,1457168773,1457168838,115
3,16640000,400000000,0.05,12,100,1456980699,1456980728,1456980742,43
4,16640000,200000000,0.5,12,100,1456988749,1456988777,1456988790,41
1,16640000,300000000,0.5,12,100,1456958857,1456958890,1456958978,121
1,104960000,6200000000,0.35,12,100,1457714996,1457715061,1457715247,251
2,99840000,6200000000,0.5,12,100,1457730688,1457730793,1457730932,244
2,104960000,6200000000,0.75,12,100,1457737431,1457737541,1457737662,231
4,128000000,5700000000,0.5,12,100,1457787691,1457787766,1457787955,264
4,20480000,2700000000,0.75,12,100,1457239921,1457240011,1457240058,137
1,168960000,3600000000,0.75,12,100,1457220524,1457220680,1457221059,535
1,76800000,800000000,0.35,12,100,1457171760,1457171810,1457171832,72
3,104960000,3800000000,0.35,12,100,1457757709,1457757772,1457757900,191
1,256000000,5700000000,0.75,12,100,1457356905,1457357017,1457357611,706
2,33280000,500000000,0.05,12,100,1456974680,1456974703,1456974824,144
2,128000000,5700000000,0.75,12,100,1457741176,1457741290,1457741412,236
1,168960000,2700000000,0.35,12,100,1457221397,1457221472,1457221486,89
4,19968000,800000000,0.75,12,100,1457191321,1457191370,1457191449,128
4,19968000,700000000,0.35,12,100,1457189928,1457189961,1457190057,129
3,99840000,500000000,0.9,12,100,1457108777,1457108842,1457108861,84
4,168960000,5700000000,0.75,12,100,1457396270,1457396395,1457396523,253
4,148480000,800000000,0.35,12,100,1457198101,1457198384,1457198445,344
2,33280000,400000000,0.05,12,100,1456973878,1456973901,1456973981,103
4,33280000,500000000,0.05,12,100,1456994766,1456994804,1456994935,169
1,256000000,1500000000,0.35,12,100,1457218311,1457218401,1457218423,112
4,19968000,1500000000,0.35,12,100,1457191787,1457191821,1457191919,132
1,128000000,6200000000,0.5,12,100,1457723301,1457723374,1457723549,248
1,99840000,380000000000,0.5,12,100,1458065251,1458069082,1458075169,9918
4,256000000,4600000000,0.35,12,100,1457388666,1457388775,1457388801,135
1,148480000,600000000,0.35,12,100,1457173574,1457173706,1457173892,318
1,168960000,1500000000,0.35,12,100,1457223675,1457224047,1457224160,485
1,128000000,380000000000,0.75,12,100,1458413452,1458419045,1458422031,8579
4,128000000,4600000000,0.75,12,100,1457785038,1457785136,1457785256,218
3,148480000,600000000,0.75,12,100,1457185970,1457186059,1457186082,112
2,104960000,3800000000,0.35,12,100,1457734996,1457735059,1457735207,211
1,104960000,570000000000,0.5,12,100,1458206831,1458212726,1458221673,14842
1,168960000,3800000000,0.35,12,100,1457364416,1457364494,1457364956,540
1,19968000,800000000,0.35,12,100,1457167759,1457167803,1457167896,137
1,76800000,600000000,0.35,12,100,1457169675,1457169994,1457170006,331
1,99840000,200000000,0.5,12,100,1456964928,1456964971,1456964985,57
3,148480000,800000000,0.75,12,100,1457187758,1457187823,1457187836,78
4,128000000,6200000000,0.5,12,100,1457791514,1457791587,1457791758,244
4,256000000,1500000000,0.35,12,100,1457245869,1457245961,1457245969,100
1,99840000,4600000000,0.35,12,100,1457702205,1457702268,1457702436,231
3,19968000,1500000000,0.35,12,100,1457180687,1457180733,1457180810,123
4,20480000,4600000000,0.75,12,100,1457383912,1457384062,1457384152,240
4,20480000,3600000000,0.35,12,100,1457238274,1457238346,1457238523,249
1,99840000,300000000,0.5,12,100,1456965714,1456965761,1456965777,63
